NO ./textures/mossy.png
SO ./textures/colorstone.png
WE ./textures/greystone.png
EA ./textures/purplestone.png
D ./textures/door.png

F 240,200,196

C 225,30,123


1011111111111111111111111
101000000110000000000001
11110000111000000000S001
10100000000000000000000111111111
111111111011000001112100000000001
100000000011000001112111111111111
11110111111111011100000010001
11110111111111011101010010001
11000000110101011100000010001
10000000000000001100000010001
10000000000000001101010010000000000
1100000111010101111101111000111
11110111  110101 101111010001
11111111  111111 111111111111