NO ./path_to_the_north_texture

SO ./path_to_the_south_texture


WE ./path_to_the_west_texture
EA ./path_to_the_east_texture


F 220,100,0

C 225,30,0




111111111111111111111111111111111
100000000000000000000000000000001
100000000000000000000000000000001
100000000000000000000011000000001
100000000000000000000011000000001
101000000000000000000000000000001
101100000000000000000000000000001
100110000011000000000000000000001
100111000000000000000000111111111
111111111111111000000000111111111
111111111111111000000000111111111
111111111111111000000000111111111
111111111111111000000000111111111
111111111111111000000000111111111
111111111111111000000000111111111
111111111111111000000000111111111
111111111111111000000000111111111
111111111111111111111111111111111