NO ./textures/wall3_dark.png
SO ./textures/wall2.png
WE ./textures/wall3.png
EA ./textures/wall2_dark.png

D ./textures/door2.png
D1 ./textures/doorWall3.png
D2 ./textures/doorWall4.png

F 50,50,56

C 68,68,68




111111111111111111111111111111111
100000000000000000000000000000001
100000000000000000000000000000001
100000000000000000000011000000001
10000000000000000000X0011000000001
101000000000000000000001000000001
101100000001000000000000000000001
100110000011000000000000000000001
100111000000000000000000111111111
111111111211111000000000111111111
111111111211111000000000111111111
111100000000001000000000111111111
111100000000001000000000111111111
111100000000001000000000111111111
111100000000001100000000111111111
111100000000002200000N00111111111
111100000000001100000000111111111
111111111111111111111111111111111