NO ./textures/mossy.png
SO ./textures/colorstone.png
WE ./textures/greystone.png
EA ./textures/purplestone.png

D ./textures/door.png
D1 ./textures/doorWall1.png
D2 ./textures/doorWall2.png

F 220,100,0

C 68,68,68




111111111111111111111111111111111
100000000000000000000000000000001
100000000000000000000000000000001
100000000000000000000011000000001
100000000000000000000011000000001
101000000000000000000001000000001
101100000001000000000000000000001
100110000011000000000000000000001
100111000000000000000000111111111
111111111111111000000000111111111
111111111111111000000000111111111
111111111111111000000000111111111
111111111111111000000000111111111
111111111111111000000000111111111
111111111111111000000000111111111
1111111111111110000N0000111111111
111111111111111000000000111111111
111111111111111111111111111111111