NO ./textures/mossy.png
SO ./textures/colorstone.png
WE ./textures/greystone.png
EA ./textures/purplestone.png


F 220,100,0

C 204,215,255




111111111111111111111111111111111
100000000000000000000000000000001
100S00000000000000000000000000001
100000000000000000000011000000001
100000000000000000000011000000001
101000000000000000000000000000001
101100000000000000000000000000001
100110000011000000000000000000001
100111000000000000000000111111111
111111111111111000000000111111111
111111111111111000000000111111111
111111111111111000000000111111111
111111111111111000000000111111111
111111111111111000000000111111111
111111111111111000000000111111111
111111111111111000000000111111111
111111111111111000000000111111111
111111111111111111111111111111111